+++++++++++++
+     +
+  +  +  +  +
+  +  S  +  +
+  +++++++  +
+           +
+++++++++++++